#########
#.......#
#...#...#
#.......#
#.......##############
#.................. .#
#............#.......#
######################